//MAP CONVERTED BY dmm2tgm.py THIS HEADER COMMENT PREVENTS RECONVERSION, DO NOT REMOVE
"a" = (
/obj/machinery/atmospherics/components/unary/vent_scrubber/on/layer4,
/turf/open/floor/mineral/abductor,
/area/ship/bridge)
"b" = (
/obj/machinery/power/smes/shuttle/precharged{
	dir = 4
	},
/obj/structure/cable{
	icon_state = "0-8"
	},
/turf/closed/wall/mineral/abductor,
/area/ship/bridge)
"c" = (
/obj/structure/closet/abductor,
/obj/item/radio/headset/abductor,
/obj/item/clothing/head/helmet/abductor,
/obj/item/clothing/suit/armor/abductor/vest,
/obj/item/storage/belt/military/abductor/full,
/obj/item/storage/belt/military/abductor/full,
/obj/item/radio/headset/abductor,
/obj/item/clothing/under/abductor,
/obj/item/clothing/under/abductor,
/obj/item/clothing/head/helmet/abductor,
/obj/item/clothing/suit/armor/abductor/vest,
/obj/item/gun/energy/alien,
/obj/item/gun/energy/alien,
/turf/open/floor/mineral/abductor,
/area/ship/bridge)
"i" = (
/obj/structure/bed/abductor,
/turf/open/floor/mineral/abductor,
/area/ship/bridge)
"j" = (
/obj/machinery/cryopod/abductor,
/turf/open/floor/mineral/abductor,
/area/ship/bridge)
"k" = (
/turf/open/floor/mineral/abductor,
/area/ship/bridge)
"l" = (
/obj/machinery/atmospherics/components/unary/outlet_injector/on/layer4{
	dir = 4
	},
/turf/open/floor/plating/abductor2,
/area/ship/external)
"m" = (
/obj/structure/cable{
	icon_state = "0-4"
	},
/obj/machinery/power/smes/engineering/abductor,
/turf/open/floor/mineral/abductor,
/area/ship/bridge)
"p" = (
/obj/machinery/computer/cargo/express{
	dir = 8
	},
/turf/open/floor/mineral/abductor,
/area/ship/bridge)
"q" = (
/obj/machinery/atmospherics/pipe/simple/scrubbers/hidden/layer4{
	dir = 4
	},
/turf/closed/wall/mineral/abductor,
/area/ship/bridge)
"r" = (
/obj/structure/cable{
	icon_state = "2-8"
	},
/obj/machinery/atmospherics/pipe/simple/scrubbers/hidden/layer4{
	dir = 1
	},
/turf/open/floor/mineral/abductor,
/area/ship/bridge)
"s" = (
/turf/closed/wall/mineral/abductor,
/area/ship/bridge)
"u" = (
/obj/machinery/atmospherics/components/unary/tank/air{
	dir = 1;
	piping_layer = 2
	},
/turf/open/floor/plating/abductor2,
/area/ship/external)
"v" = (
/obj/machinery/power/smes/shuttle/precharged{
	dir = 8
	},
/obj/structure/cable{
	icon_state = "0-4"
	},
/obj/machinery/atmospherics/pipe/simple/supply/hidden/layer2{
	dir = 4
	},
/turf/closed/wall/mineral/abductor,
/area/ship/bridge)
"y" = (
/obj/machinery/atmospherics/pipe/simple/scrubbers/hidden/layer4{
	dir = 9
	},
/turf/closed/wall/mineral/abductor,
/area/ship/bridge)
"A" = (
/obj/machinery/power/terminal,
/obj/structure/cable,
/obj/machinery/light{
	dir = 8;
	light_color = "#511bb5"
	},
/obj/machinery/rnd/server,
/turf/open/floor/mineral/abductor,
/area/ship/bridge)
"B" = (
/obj/machinery/atmospherics/pipe/simple/supply/hidden/layer2,
/turf/open/floor/mineral/abductor,
/area/ship/bridge)
"H" = (
/obj/machinery/power/shuttle/engine/electric{
	dir = 8
	},
/obj/structure/cable{
	icon_state = "0-8"
	},
/obj/machinery/atmospherics/pipe/simple/supply/hidden/layer2{
	dir = 10
	},
/turf/closed/wall/mineral/abductor,
/area/ship/bridge)
"I" = (
/obj/machinery/atmospherics/components/unary/vent_pump/on/layer2,
/turf/open/floor/mineral/abductor,
/area/ship/bridge)
"J" = (
/obj/machinery/power/shuttle/engine/electric{
	dir = 4
	},
/obj/structure/cable{
	icon_state = "0-4"
	},
/turf/closed/wall/mineral/abductor,
/area/ship/bridge)
"M" = (
/obj/docking_port/mobile{
	dir = 2;
	launch_status = 0;
	name = "NT Frigate";
	port_direction = 8;
	preferred_direction = 4
	},
/obj/structure/fans/tiny,
/obj/machinery/door/airlock/abductor,
/turf/open/floor/plating/abductor2,
/area/ship/bridge)
"N" = (
/obj/machinery/power/terminal{
	dir = 8
	},
/obj/structure/cable{
	icon_state = "0-4"
	},
/obj/structure/cable{
	icon_state = "1-4"
	},
/obj/machinery/airalarm/directional/south,
/obj/machinery/atmospherics/pipe/simple/scrubbers/hidden/layer4{
	dir = 1
	},
/obj/machinery/rnd/production/circuit_imprinter,
/turf/open/floor/mineral/abductor,
/area/ship/bridge)
"R" = (
/obj/machinery/computer/helm,
/turf/open/floor/mineral/abductor,
/area/ship/bridge)
"T" = (
/obj/structure/table/abductor,
/obj/item/retractor/alien,
/obj/item/scalpel/alien,
/obj/item/surgicaldrill/alien,
/obj/item/hemostat/alien,
/obj/item/circular_saw/alien,
/obj/item/cautery/alien,
/obj/machinery/light{
	dir = 4;
	light_color = "#511bb5"
	},
/obj/item/storage/box/alienhandcuffs,
/turf/open/floor/mineral/abductor,
/area/ship/bridge)
"V" = (
/obj/machinery/power/terminal{
	dir = 4
	},
/obj/structure/cable{
	icon_state = "0-8"
	},
/obj/machinery/atmospherics/pipe/simple/supply/hidden/layer2{
	dir = 5
	},
/obj/machinery/rnd/production/protolathe,
/turf/open/floor/mineral/abductor,
/area/ship/bridge)
"W" = (
/turf/template_noop,
/area/template_noop)
"X" = (
/obj/structure/cable{
	icon_state = "4-8"
	},
/obj/machinery/light{
	light_color = "#511bb5"
	},
/obj/structure/cable{
	icon_state = "0-4"
	},
/obj/machinery/power/apc/auto_name/south,
/obj/machinery/computer/rdconsole{
	dir = 1
	},
/turf/open/floor/mineral/abductor,
/area/ship/bridge)
"Z" = (
/obj/structure/cable{
	icon_state = "0-2"
	},
/obj/machinery/power/rtg/abductor,
/turf/open/floor/mineral/abductor,
/area/ship/bridge)

(1,1,1) = {"
W
s
s
s
s
J
l
"}
(2,1,1) = {"
s
s
Z
A
m
b
q
"}
(3,1,1) = {"
s
j
k
a
r
N
y
"}
(4,1,1) = {"
M
k
k
i
k
X
s
"}
(5,1,1) = {"
s
R
k
I
B
V
s
"}
(6,1,1) = {"
s
s
p
T
c
v
s
"}
(7,1,1) = {"
W
s
s
s
s
H
u
"}
