//MAP CONVERTED BY dmm2tgm.py THIS HEADER COMMENT PREVENTS RECONVERSION, DO NOT REMOVE
"a" = (
/obj/structure/window/reinforced{
	dir = 4
	},
/obj/machinery/suit_storage_unit/syndicate,
/obj/structure/closet/emcloset/wall{
	dir = 1;
	pixel_y = -28
	},
/turf/open/floor/plasteel/dark,
/area/ship/bridge)
"b" = (
/obj/machinery/power/apc/auto_name/south,
/obj/structure/cable{
	icon_state = "0-1"
	},
/turf/open/floor/plasteel/tech/grid/airless,
/area/ship/bridge)
"c" = (
/obj/structure/table/reinforced,
/obj/structure/closet/secure_closet/wall{
	icon_door = "sec_wall";
	icon_state = "sec_wall";
	name = "gun locker";
	req_access_txt = "19";
	pixel_y = -30;
	dir = 1
	},
/obj/item/toy/plush/among{
	pixel_y = 7;
	pixel_x = 11;
	name = "Slasher Plushie"
	},
/obj/machinery/jukebox/boombox{
	pixel_y = -9
	},
/obj/item/ammo_box/magazine/smgm10mm{
	pixel_x = -5;
	pixel_y = 5
	},
/obj/item/ammo_box/magazine/smgm10mm{
	pixel_x = -5;
	pixel_y = 5
	},
/obj/item/ammo_box/magazine/smgm10mm{
	pixel_x = -5;
	pixel_y = 5
	},
/obj/item/gun/ballistic/automatic/smg/inteq{
	pixel_y = -2
	},
/obj/item/storage/toolbox/ammo/c10mm{
	pixel_x = 2;
	pixel_y = 7
	},
/turf/open/floor/plasteel/tech/grid/airless,
/area/ship/bridge)
"d" = (
/obj/structure/cable{
	icon_state = "1-2"
	},
/turf/open/floor/plasteel/tech/grid/airless,
/area/ship/bridge)
"e" = (
/obj/machinery/door/poddoor{
	id = "shattersyndie"
	},
/obj/effect/spawner/structure/window/plasma/reinforced/plastitanium,
/turf/open/floor/plating,
/area/ship/bridge)
"f" = (
/obj/machinery/power/port_gen/pacman,
/obj/machinery/power/terminal{
	dir = 4
	},
/obj/item/stack/sheet/mineral/plasma/twenty,
/obj/item/stack/sheet/mineral/plasma/twenty,
/turf/open/floor/plasteel/dark,
/area/ship/bridge)
"h" = (
/obj/structure/cable{
	icon_state = "2-8"
	},
/turf/open/floor/plasteel/tech/grid/airless,
/area/ship/bridge)
"i" = (
/obj/machinery/power/terminal{
	dir = 8
	},
/obj/structure/cable{
	icon_state = "0-4"
	},
/obj/effect/turf_decal/industrial/warning{
	dir = 4
	},
/obj/machinery/atmospherics/pipe/simple/supply/hidden/layer2{
	dir = 6
	},
/obj/item/storage/toolbox/syndicate,
/turf/open/floor/plasteel/dark,
/area/ship/bridge)
"j" = (
/obj/structure/window/reinforced{
	dir = 8
	},
/obj/machinery/atmospherics/components/unary/vent_scrubber/on/layer4{
	filter_types = list("n2","co2","bz","water_vapor","miasma","freon","pluox","tritium","n20","no2","nob");
	id_tag = null
	},
/obj/structure/cable{
	icon_state = "4-8"
	},
/turf/open/floor/plasteel/tech/grid/airless,
/area/ship/bridge)
"k" = (
/obj/structure/window/reinforced{
	dir = 4
	},
/obj/machinery/atmospherics/pipe/simple/scrubbers/hidden/layer4{
	dir = 4
	},
/obj/machinery/atmospherics/pipe/simple/supply/hidden/layer2{
	dir = 5
	},
/obj/structure/cable{
	icon_state = "1-8"
	},
/turf/open/floor/plasteel/dark,
/area/ship/bridge)
"l" = (
/obj/structure/cable{
	icon_state = "2-8"
	},
/turf/open/floor/plasteel/dark,
/area/ship/bridge)
"m" = (
/obj/machinery/computer/cargo/express{
	dir = 8
	},
/turf/open/floor/plasteel/tech/grid/airless,
/area/ship/bridge)
"n" = (
/obj/machinery/door/window/eastleft,
/obj/machinery/atmospherics/pipe/simple/supply/hidden/layer2{
	dir = 10
	},
/obj/structure/cable{
	icon_state = "1-8"
	},
/obj/structure/cable{
	icon_state = "1-2"
	},
/turf/open/floor/plasteel/dark,
/area/ship/bridge)
"o" = (
/obj/machinery/atmospherics/components/unary/vent_pump/on/layer2,
/obj/structure/cable{
	icon_state = "4-8"
	},
/turf/open/floor/plasteel/tech/grid/airless,
/area/ship/bridge)
"q" = (
/obj/machinery/atmospherics/pipe/simple/supply/hidden/layer2{
	dir = 9
	},
/turf/open/floor/plasteel/tech/grid/airless,
/area/ship/bridge)
"r" = (
/obj/machinery/autolathe/hacked,
/obj/structure/window/reinforced{
	dir = 8
	},
/obj/machinery/button/door{
	dir = 1;
	id = "bug_south";
	pixel_x = 9;
	pixel_y = -25;
	name = "BlastDoor Button"
	},
/obj/machinery/button/door{
	dir = 1;
	id = "shattersyndie";
	pixel_x = -6;
	pixel_y = -25;
	name = "BlastWindow Button"
	},
/turf/open/floor/plasteel/tech/grid/airless,
/area/ship/bridge)
"u" = (
/obj/machinery/power/terminal{
	dir = 8
	},
/obj/structure/cable{
	icon_state = "0-4"
	},
/obj/machinery/atmospherics/pipe/simple/scrubbers/hidden/layer4{
	dir = 4
	},
/obj/effect/turf_decal/industrial/warning{
	dir = 4
	},
/obj/machinery/atmospherics/components/binary/pump/layer2{
	dir = 1
	},
/turf/open/floor/plasteel/dark,
/area/ship/bridge)
"v" = (
/obj/machinery/power/shuttle/engine/electric{
	dir = 4
	},
/obj/machinery/atmospherics/components/unary/outlet_injector/on/layer4{
	dir = 4
	},
/obj/structure/cable{
	icon_state = "0-4"
	},
/turf/open/floor/plating,
/area/ship/bridge)
"x" = (
/obj/machinery/atmospherics/components/unary/tank/air{
	piping_layer = 2;
	dir = 8
	},
/turf/open/floor/plasteel/dark,
/area/ship/bridge)
"y" = (
/obj/machinery/portable_atmospherics/canister/air,
/turf/open/floor/plasteel/tech/grid/airless,
/area/ship/bridge)
"z" = (
/obj/structure/window/plasma/reinforced/spawner/west,
/obj/machinery/power/smes/shuttle/precharged{
	dir = 4
	},
/obj/machinery/door/window/eastleft,
/obj/machinery/atmospherics/pipe/simple/scrubbers/hidden/layer4{
	dir = 4
	},
/obj/structure/cable{
	icon_state = "0-8"
	},
/turf/open/floor/plating,
/area/ship/bridge)
"A" = (
/obj/machinery/atmospherics/components/unary/vent_scrubber/on/layer4{
	filter_types = list("n2","co2","bz","water_vapor","miasma","freon","pluox","tritium","n20","no2","nob");
	id_tag = null
	},
/turf/open/floor/plasteel/dark,
/area/ship/bridge)
"C" = (
/obj/structure/window/plasma/reinforced/spawner/west,
/obj/machinery/power/smes/shuttle/precharged{
	dir = 4
	},
/obj/machinery/door/window/eastleft,
/obj/structure/cable{
	icon_state = "0-8"
	},
/turf/open/floor/plating,
/area/ship/bridge)
"D" = (
/obj/structure/tank_dispenser/oxygen,
/turf/open/floor/plasteel/tech/grid/airless,
/area/ship/bridge)
"E" = (
/obj/structure/chair/comfy/shuttle{
	dir = 4
	},
/turf/open/floor/plasteel/tech/grid/airless,
/area/ship/bridge)
"F" = (
/turf/closed/wall/mineral/plastitanium,
/area/ship/bridge)
"G" = (
/obj/machinery/atmospherics/pipe/simple/scrubbers/hidden/layer4{
	dir = 4
	},
/obj/machinery/atmospherics/pipe/manifold/supply/hidden/layer2,
/turf/open/floor/plasteel/dark,
/area/ship/bridge)
"I" = (
/turf/template_noop,
/area/template_noop)
"J" = (
/obj/machinery/door/window/eastleft{
	dir = 8
	},
/obj/machinery/atmospherics/pipe/simple/scrubbers/hidden/layer4{
	dir = 9
	},
/obj/machinery/atmospherics/pipe/simple/supply/hidden/layer2{
	dir = 8
	},
/turf/open/floor/plasteel/tech/grid/airless,
/area/ship/bridge)
"K" = (
/obj/machinery/computer/helm{
	dir = 8
	},
/turf/open/floor/plasteel/tech/grid/airless,
/area/ship/bridge)
"L" = (
/obj/machinery/power/smes/engineering,
/obj/structure/window/reinforced{
	dir = 4
	},
/obj/structure/cable{
	icon_state = "0-2"
	},
/obj/structure/cable{
	icon_state = "0-4"
	},
/turf/open/floor/plasteel/dark,
/area/ship/bridge)
"M" = (
/obj/machinery/power/shuttle/engine/electric{
	dir = 4
	},
/obj/structure/cable{
	icon_state = "0-4"
	},
/turf/open/floor/plating,
/area/ship/bridge)
"N" = (
/turf/open/floor/plasteel/dark,
/area/ship/bridge)
"O" = (
/obj/structure/table/reinforced,
/obj/structure/closet/secure_closet/wall{
	icon_door = "sec_wall";
	icon_state = "sec_wall";
	name = "gun locker";
	req_access_txt = "19";
	pixel_y = 30
	},
/obj/item/ammo_box/magazine/smgm10mm{
	pixel_x = -5;
	pixel_y = 5
	},
/obj/item/ammo_box/magazine/smgm10mm{
	pixel_x = -5;
	pixel_y = 5
	},
/obj/item/ammo_box/magazine/smgm10mm{
	pixel_x = -5;
	pixel_y = 5
	},
/obj/item/gun/ballistic/automatic/smg/inteq{
	pixel_y = -2
	},
/obj/item/storage/toolbox/ammo/c10mm{
	pixel_x = 2;
	pixel_y = 7
	},
/turf/open/floor/plasteel/tech/grid/airless,
/area/ship/bridge)
"Q" = (
/obj/machinery/cryopod,
/obj/machinery/vending/wallmed{
	pixel_y = 30
	},
/turf/open/floor/plasteel/tech/grid/airless,
/area/ship/bridge)
"R" = (
/obj/structure/window/reinforced{
	dir = 8
	},
/obj/structure/closet/wall/white/med{
	pixel_y = 30
	},
/obj/structure/table/reinforced,
/obj/machinery/cell_charger,
/obj/item/gps{
	gpstag = "MasinyaneVessel"
	},
/obj/item/storage/firstaid/tactical,
/obj/item/storage/firstaid/fire,
/obj/item/storage/firstaid/advanced,
/obj/item/storage/backpack/duffelbag/med/surgery,
/obj/item/defibrillator/compact,
/obj/item/clothing/glasses/hud/health,
/obj/item/healthanalyzer,
/turf/open/floor/plasteel/tech/grid/airless,
/area/ship/bridge)
"S" = (
/obj/machinery/cryopod,
/obj/item/radio/intercom{
	freerange = 1;
	freqlock = 1;
	frequency = 1347;
	name = "IRMG shortwave intercom";
	pixel_y = 22
	},
/turf/open/floor/plasteel/tech/grid/airless,
/area/ship/bridge)
"T" = (
/obj/machinery/vending/cigarette/syndicate,
/obj/machinery/airalarm/all_access{
	dir = 1;
	pixel_y = -24
	},
/turf/open/floor/plasteel/tech/grid/airless,
/area/ship/bridge)
"U" = (
/obj/machinery/atmospherics/components/unary/vent_pump/on/layer2,
/obj/structure/cable{
	icon_state = "1-4"
	},
/turf/open/floor/plasteel/dark,
/area/ship/bridge)
"V" = (
/obj/structure/cable{
	icon_state = "4-8"
	},
/turf/open/floor/plasteel/dark,
/area/ship/bridge)
"W" = (
/obj/structure/fans/tiny,
/obj/machinery/door/poddoor{
	id = "bug_south"
	},
/turf/open/floor/plasteel/dark,
/area/ship/bridge)
"Z" = (
/obj/machinery/atmospherics/pipe/manifold/scrubbers/hidden/layer4,
/obj/machinery/atmospherics/pipe/simple/supply/hidden/layer2{
	dir = 8
	},
/turf/open/floor/plasteel/dark,
/area/ship/bridge)

(1,1,1) = {"
F
I
M
v
I
F
"}
(2,1,1) = {"
F
F
C
z
F
F
"}
(3,1,1) = {"
e
f
i
u
x
e
"}
(4,1,1) = {"
F
L
n
k
a
F
"}
(5,1,1) = {"
W
V
A
Z
N
W
"}
(6,1,1) = {"
W
l
U
G
N
W
"}
(7,1,1) = {"
F
R
j
J
r
F
"}
(8,1,1) = {"
F
Q
o
q
T
F
"}
(9,1,1) = {"
F
S
h
d
b
F
"}
(10,1,1) = {"
F
O
E
E
c
F
"}
(11,1,1) = {"
e
D
K
m
y
e
"}
(12,1,1) = {"
e
e
e
e
e
e
"}
